9 20
11111111111111111111
12222122222222122221
12112121122112121121
12222220303312222221
12121121101112112121
12122221022212122121
12121121011012121121
12122222202222122221
11111111111111111111
7 9