27 28
1111111111111111111111111111
1222222222222112222222222221
1211112111112112111112111121
1211112111112112111112111121
1211112111112112111112111121
1222222222222222222222222221
1211112112111111112112111121
1211112112111111112112111121
1222222112222112222112222221
1111112111110110111112111111
1111112111110110111112111111
1111112100000000000012111111
1111112101111001111012111111
1000002001300330031002000001
1111112101111111111012111111
1111112100000000000012111111
1111112101111111111012111111
1222222222222112222222222221
1211112111112112111112111121
1211112111112112111112111121
1222112222222002222222112221
1112112112111111112112112111
1112112112111111112112112111
1222222112222112222112222221
1211111111112112111111111121
1222222222222202222222222221
1111111111111111111111111111
25 14