5 20
11111111111111111111
12000000000002220021
12112112112112110121
10110122222000000121
11111111111111111111
1 16