7 20
11111111111111111111
12222221300312222221
12112221100112221121
12122122222222122121
12112121111112121121
12222222202222222221
11111111111111111111
5 9