20 20
11111111111111111111
10011011001111100001
10110101110000010011
10100000011000001111
10000010010111010011
11010100000111010001
10010100100100000001
10101010001010010001
10101102010001110011
10001100000001001011
10101011110000101001
11000110010100100111
11000010000100100001
10001110010001100101
11000000001100110001
11110010000011111011
10000100001100101101
10100000100011100011
10000010001001001111
11111111111111111111
15 3