20 20
11111111111111111111
10100000110110010001
10010000011000000111
10010011011001110001
10010000110000000001
10100120010110001011
10000000001001100001
10011011000000001001
10000000000100000001
10001000011001001001
10001001001001100001
11000100101100010101
11101010000100001001
10100000000001000101
11101000000001100001
10011100000100000111
10000001101100000011
10001100000001000001
10011001100101000011
11111111111111111111
16 10