8 8
11111111
12000021
10000001
10111101
10100001
10101111
12100021
11111111
2 4