37 37
1111111111111111111111111111111111111
1200000010000000000000000000000000121
1000000000111110101110111011111110101
1000000010000000101000001000001010001
1111101111101110101010111011111010111
1000101010100010101010001010000010001
1011101010101110111110111010111011101
1000000010000010001000100000101010001
1110111111111011111110111011101010101
1000000000000010000000101000100000101
1010111110101110101011101011101110101
1010100000101010101000001000101010101
1010101111111010111111111011101011101
1010101000001000100000100000100010001
1110111010111110111110111011101111101
1000001010000000000000001010001010101
1010101010010011101110111010101010101
1010101010110010101010100010101000001
1010111110010011101110101110111011111
1000000010010010101010100000001010001
1011101010010011101110111111111010111
1000101000000000000000000010001010001
1011101111111111111111111110101011101
1010000000000000000000000000100000001
1010101111101110101010101111111111111
1010100010000010101010000000100010101
1010111011101010101111111110111010101
1010001010001010100010100010101000001
1011101110111010111010101111101011111
1000000010001000001000000010001010001
1110101111101111101110111010111010111
1010101010101010000010100010100010101
1010111010101010111111111010101010101
1000000010000000000000000000001000001
1010001011101110111111101110111011101
1210001000000010000000000010000010021
1111111111111111111111111111111111111
27 17