37 37
1111111111111111111111111111111111111
1000000010101000000000001000100000101
1011111110101110101110111011111110101
1000000010000000101000001000001010001
1111101111101110101010111011111010111
1000101010100010101010001010001010001
1011101010101110111110111010111011101
1000000010000010001000100000101010001
1110111111111011111110111011101010101
1000000000000010000000101000100000101
1010111110101110101011101011101110101
1010100000101010101000001000101010101
1010101111111010111111111011101011101
1010101000001000100000100000100010001
1110111010111110111110111011101111101
1000001010100000101000001010001010101
1010101010111011101110111010101010101
1010101010000000000000000010101000001
1110111111101010111110111010111011111
1000000010101010000010001000001010001
1111101010111111111011111111111010111
1000101000000000001010000010001010001
1011101111101111111110111110101011101
1010001000000100000000100000100000001
1010101111101110101010101111111111111
1010100010000010101010000000100010101
1010111011101010101111111110111010101
1010001010001010100010100010101000001
1011101110111110111010101111101011111
1000000010001000001010000010001010001
1110101111101111101110111010111010111
1010101010101010000010100010100010101
1010111010101010111111111010101010101
1000100010001000000000000000001000001
1010101011101110111111101110111011101
1210101000000010001000000010001010001
1111111111111111111111111111111111111
35 35