8 31
1111111111111111111111111111111
1212222222221103010021111222221
1212111111121111110111111121121
1222222222222122212222222222221
1111122211122000002212122212111
1211121111121111111211121211111
1000022222222220222212221200021
1111111111111111111111111111111
6 15