14 14
11111111111111
12020202020101
10000000000101
12020202020131
10000000000101
12020202020101
10000000000101
12020202020101
10000000000131
12020202020101
10000000000101
12020202020101
10000000000101
11111111111111
8 6