7 19
1111111111111111111
1320000000300022221
1210101111110121121
1212101000210122121
1211121001110122121
1222220000000122131
11111111111111111111
5 8