8 6
111111
122221
101121
101121
120021
121111
122221
111111
4 2