18 36
111111111111111111111111111111111111
100000000000000000000000000000000001
101111111111111111111111131111111101
101100010001000000111111100011000001
101101010101011110111111111011011111
101101010101000000000000011011000001
101101010101010111100111000011111101
101001010100010000110111111110000001
101101010111111110110000000011011111
101101000110000000111111111011000001
100001111110111111100000011011111101
111111000000100000001111011010000001
100000011111101111101000011011011111
101111110000001000000011111011000001
100000000111111011111111111011001101
111111111100000000000000000011111101
120000000001111111111111111000030001
111111111111111111111111111111111111
1 34