8 31
1111111111111111111111111111111
1222222222222111112222222222221
1112122211122222222212122212111
1222111212111121211111121112221
1212222212222221222222122222121
1211121111121111111211121211111
1222221222222220222212221222221
1111111111111111111111111111111
6 15