18 38
11111111111111111111111111111111111111
10000000000000000000000000000000000001
10111111111111111111101110011111111001
10110001000100000011101110000113300001
10110101010101111011111111100110011111
10110101010101000011330000000110000001
10110101010101011111001110000111111001
10110101010001000011001111111110000001
10110101011111111011000000000110011111
10110100011000000011111111100110000001
10000111011011111110000001100111111001
11111100000010000000100001100110000001
10000001111110110001100001100110011111
10111111000000100000001111100110000001
10000000000111100000001111100111111001
11111111000100000000000000000111111001
12000000000111111111111111100000000001
11111111111111111111111111111111111111
1 36