11 20
11111111111111111111
12222122222222122221
12112121111112121121
12122222222222222121
12121121100112112121
12222221300312222221
12121121111112112121
12122222222222222121
12112121111112121121
12222122202222122221
11111111111111111111
9 9