6 31
1111111111111111111111111111111
1210000022221103011111100021121
1212111111121111111000001111121
1011121111121111111211121211121
1000022222222220222212222222221
1111111111111111111111111111111
4 15