14 30
111111111111111111111111111111
120000001010100000000000000121
100000001010111111011111110101
100000001000000001000001010001
111110111110111011011111010111
100010101010001000010000010001
101110101010111111110111011101
100000001000001100000101010001
111010111111101111011101010101
101000000000001100000100000101
101011111010111101011101110101
100010000010000001010001011101
120010111110000001011101000021
111111111111111111111111111111
12 5