5 9
111111111
120000031
101213111
130000111
111111111
1 2