7 20
11111111111111111111
12221222222222112221
12121211111111112121
12222222222222222221
11111111212111111101
11111111222222200001
11111111111111111111
4 18