9 25
1111111111111111111111111
1220000222200000022220001
1220022200222002220022201
1220022200222002220022201
1220000222200000022220301
1220022200222002220022201
1220022200222002220022201
1220000222200000022220021
1111111111111111111111111
1 4