23 37
1111111111111111111111111111111111111
1000000000000000000000000000000000001
1000000000000100000000000000000000001
1000000000000100000000000000000000001
1000000000000100000000000000000000001
1000000000000100000000000000000000001
1000000000000100000000000000000000001
1000000000000100000010000000000000001
1000000000000100000010000000000000001
1000000000000100000010000000000000001
1000000000000100000010000000000000001
1000000000000100000010000000000000001
1000000000000100000010000000000000001
1000000000000100000010000000000000001
1111111111111100000011111111111111111
1000000000000100000000000000000000001
1000000000000100000000000000000000001
1000000000000100000000000000000000001
1000000000000000000000000000000000001
1000000000000000000000000000000000001
1000000000000000000000000000000000001
1200000000000000000000000000000000001
1111111111111111111111111111111111111
1 35