7 20
11111111111111111111
12222222222222222221
12222222222222222221
12222222202222222221
12222222222222222221
12222222222222222221
11111111111111111111
3 9