7 20
11111111111111111111
12222221333312222221
12212221100112221221
12122122222222122121
12212121111112121221
12222222202222222221
11111111111111111111
5 9