15 9
111111111
122010301
111011111
100000001
111111101
100000001
101111101
100000101
111110101
100000121
101111111
100000021
111111121
102000021
111111111
13 1