10 22
1111111111111111111111
1011000000001010000001
1000011111101011111101
1111110000000010000001
1000010111111011011111
1011110100000000010001
1000000001110111000101
1111111111000011111101
1200000000011000000001
1111111111111111111111
3 11