5 5
11111
12001
11101
12001
11111
1 2