%%%%%%%
%.    %
% %%% %
%  %  %
%%   %%
%P %%%%
%%%%%%%
