7 9
111111111
103012221
111111101
102000001
121121121
121122221
111111111
3 1