7 7
1111111
1200001
1011101
1001001
1100011
1001111
1111111
5 1