7 9
111111111
122000221
111121101
100000001
121101121
121200021
111111111
3 4