5 8
11111111
10000031
13111111
12222001
11111111
1 4