7 20
11111111111111111111
12000000000002210001
12112112112112110101
10000000000000000101
11111111111111111101
12222200000000000001
11111111111111111111
3 9