%%%%%%%
%    P%
% % % %
%%% % %
%    %%
%. %%%%
%%%%%%%
