10 5
11111
10201
12321
10201
12021
10001
10021
10001
10021
11111
8 1