13 20
11111111111111111111
12222122222222122221
12112121122112121121
12122222122122222121
12121121100112112121
12222220333312122221
12122221111112122121
12122221002212122121
12122221011112122121
12122222222222122121
12112121111112121121
12222122202222122221
11111111111111111111
11 9